NO IMG/Wolfenstein/bluestone.xpm
SO IMG/Wolfenstein/greystone.xpm

WE IMG/Wolfenstein/wood.xpm
EA IMG/Wolfenstein/redbrick.xpm



F 220,100,0
C 225,30,0


111111
100001
10N001
110001
111111